%%%%%%%%%%%%%%%%%%%%%%%%%%%%%%%
% %              %   %%%%     %
% % %%%%%%% %%%%%% %%%%%%% %% %
%            %   %            %
%%%%%   %%%         % %   % %%%
% %%% %%%%% %%%%%%% %%% % %%%%%
%                   %   %     %
%%%%%%%%%%%%%%%%%%%%%%%%%%%%%%%
