%%%%%%%%%%%%%%%%%%%
%                 %
% % % %%%%%% % %% %
% % % %    % %  % %
% %%% %  %%% %  % %
%            %  % %
%%%%%%%%%%%%%%%%%%%%
