%%%%%%%%%%%%%%%%%%%%
%    %        %    %
% %% % %%  %% % %% %
%           %      %
% % %% %% %%% %% % %
% %    %    % %  % %
% % %% % %% % % %% %
% %           %    %
%%%%%%%%%%%%%%%%%%%%
