%%%%%%
%    %
% %% %
% %% %
%    %
% %%%%
%    %
%%%%%%