%%%%%%%%%%%%%%%%%%%%%%%%%%%%%%%
% %              %%%%%%    %% %
% % %%%%%%% %%%%%%%     %%%%% %
% %%% %%%%% %%%%%%% %%% % %%% %
%                   %         %
%%%%%%%%%%%%%%%%%%%%%%%%%%%%%%%
