%%%%%%%%%%%%%%%%%%%%
%   %         %%   %
% % % %%%%%%%%%% % %
%                  %
%%%%%%%% % %%%%%%% %
%%%%%%%%           %
%%%%%%%%%%%%%%%%%%%%
