%%%%%%%%%%%%%%%%%%%%
%      %    %      %
%  %   %%  %%   %  %
% %  %        %  % %
%  % % %%%%%% % %  %
%                  %
%%%%%%%%%%%%%%%%%%%%
