%%%%%%%%%
%       %
%%% %%%%%
%       %
%%%%%%% %
%       %
% %%%%% %
%     % %
%%%%% % %
%     % %
% %%%%%%%
%       %
%%%%%%% %
%       %
%%%%%%%%%
