%%%%%%%%%%%%%%%%%%%%
%              %   %
% %% %% %% %% %% % %
%                % %
%%%%%%%%%%%%%%%%%% %
%                  %
%%%%%%%%%%%%%%%%%%%%
