%%%%%%%%%%%%%%%%%%%%%%%%%%%%%%%
%.%     ....   G %%%%%%   o%%.%
%.%o%%%%%%%.%%%%%%%     %%%%%.%
% %%%.%%%%%.%%%%%%%.%%%.%.%%%.%
%    ..........Po...%.........%
%%%%%%%%%%%%%%%%%%%%%%%%%%%%%%%
