%%%%%%%%%%%%%%%%%%%%%%%%%%%%%%%%%%%%
%       .                          %
% %%%%%%%%%%%%%%%%%%% %%% %%%%%%%% %
% %%   %   %      %%% %%%   %%     %
% %% % % % % %%%% %%%%%%%%% %% %%%%%
% %% % % % % %    %%     %% %%     %
% %% % % % % % %%%%  %%%    %%%%%% %
% %  % % %   %    %% %%%%%%%%      %
% %% % % %%%%%%%% %%        %% %%%%%
% %% %   %%       %%%%%%%%% %%     %
%    %%%%%% %%%%%%%      %% %%%%%% %
%%%%%%      %       %%%% %% %      %
%      %%%%%% %%%%% %    %% %% %%%%%
% %%%%%%      %       %%%%% %%     %
%        %%%%%% %%%%%%%%%%% %%  %% %
%%%%%%%%%%                  %%%%%% %
%          %%%%%%%%%%%%%%%%      P %
%%%%%%%%%%%%%%%%%%%%%%%%%%%%%%%%%%%%