%%%%%%%%%%%%%%%%%%%%%%%%%%%%%%%
%     %                 %    .%
% %%% % %%% %%%%%%% %%% %     %
% %   % %      %      % %     %
%   %%% % %%%% % %%%%   %%%   %
%%% % % % %      %  % %   % %%%
%   % %%% % %%% %%% % %%% %   %
% %%%P      %     %       %%% %
%   % %%%%% %%%%%%% % %%% %   %
%%% %   % %    %    % %   % %%%
%   %%% % %%%% % %%%% % %%%   %
%       %      %      %     % %
%     % %%% %%%%%%% %%% % %%% %
%     %             %   %     %
%%%%%%%%%%%%%%%%%%%%%%%%%%%%%%%
