%%%%%%%%%%%%%%%%%%%%%%%%%%%%%%%
% %             %   %%%%     %
% % %%%%%%% %%%%%% %%%%%%% %% %
%P           %   %   .        %
%%%%%   %%%         % %   % %%%
% %%% %%%%% %%%%%%% %%% % %%%%%
%                   %   %     %
%%%%%%%%%%%%%%%%%%%%%%%%%%%%%%%
