%%%%%%%%%%%%%%%%%%%%%%%%%%%%%%%
%P           %%%%%            %
%%% %   %%%         % %   % %%%
%   %%% % %%%% % %%%%%% %%%   %
% %     %      %      %     % %
% %%% %%%%% %%%%%%% %%% % %%%%%
%     %             % . %     %
%%%%%%%%%%%%%%%%%%%%%%%%%%%%%%%
