%%%%%%%%%%%%%%%%%%%%%%%%%%%%%%
%       % % %           .  % %
%       % % %%%%%% %%%%%%% % %
%       %        %     % %   %
%%%%% %%%%% %%% %% %%%%% % %%%
%   % % % %   %    %     %   %
% %%% % % % %%%%%%%% %%% %%% %
%       %     %%     % % %   %
%%% % %%%%%%% %%%% %%% % % % %
% %           %%     %     % %
% %P%%%%% % %%%% % %%% %%% % %
%   %     %      % %   % %%% %
%   % %%%%%      % %%% %     %
%%%%%%%%%%%%%%%%%%%%%%%%%%%%%%