%%%%%%%%%%%%%%%%%%%%%%%%%%%%%%%
% %              %%%%%%    %% %
% % %%%%%%% %%%%%%%     %%%%% %
% %%% %%%%% %%%%%%% %%% % %%%.%
%P                  %         %
%%%%%%%%%%%%%%%%%%%%%%%%%%%%%%%
