%%%%%%%%%%%%%%%%%%%%%%%%%%%%%%%
% %              %%%%%%  P %% %
% % %%%%%%% %%%%%%%     %%%%% %
% %%% %%%%% %%%%%%% %%% % %%% %
%  .                %         %
%%%%%%%%%%%%%%%%%%%%%%%%%%%%%%%
