%%%%%%%%%%%%%%%%%%%%
%    %        %   P%
% %% % %%%%%% % %% %
% %              % %
% % %% %%  %% %% % %
% .    %    %      %
% % %% %%%%%% %% % %
% %              % %
% %% % %%%%%% % %% %
%    %        %    %
%%%%%%%%%%%%%%%%%%%%
