%%%%%%%%%%%%%%%%%%%%%%%%%%%%%%%%%%%%
%                          P       %
% %%%%%%%%%%%%%%%%%%% %%% %%%%%%%% %
% %%   %   %      %%% %%%   %%     %
% %% % % % % %%%% %%%%%%%%% %% %%%%%
% %% % % % % %    %%     %% %%     %
% %% % % % % % %%%%  %%%    %%%%%% %
% %  % % %   %    %% %%%%%%%%      %
% %% % % %%%%%%%% %%        %% %%%%%
% %% %   %%       %%%%%%%%% %%     %
%    %%%%%% %%%%%%%      %% %%%%%% %
%%%%%% .    %       %%%% %% %      %
%      %%%%%% %%%%% %    %% %% %%%%%
% %%%%%%      %       %%%%% %%     %
%        %%%%%% %%%%%%%%%%% %%  %% %
%%%%%%%%%%                  %%%%%% %
%          %%%%%%%%%%%%%%%%        %
%%%%%%%%%%%%%%%%%%%%%%%%%%%%%%%%%%%%