%%%%%%%%%%%%%%%%%%%%%%%%%%%%%%%
%            %%%%%            %
%%% %   %%%         % %   % %%%
%   %%%P% %%%% % %%%%%% %%%   %
% %     %      %      %     % %
% %%% %%%%% %%%%%%% %%% % %%%%%
%     %             %   %    .%
%%%%%%%%%%%%%%%%%%%%%%%%%%%%%%%
