%%%%%%%%%%%%%%%%%%%%%%%%%%%%%%%
% %   P          %%%%%%    %%.%
% % %%%%%%% %%%%%%%     %%%%% %
% %%% %%%%% %%%%%%% %%% % %%% %
%                   %         %
%%%%%%%%%%%%%%%%%%%%%%%%%%%%%%%
