%%%%%%%%%%%%%%%%%%%%%%%%%%%%%%%
% %.             %%%%%%    %% %
% % %%%%%%% %%%%%%%     %%%%% %
% %%% %%%%% %%%%%%% %%% % %%% %
%                   %        P%
%%%%%%%%%%%%%%%%%%%%%%%%%%%%%%%
