%%%%%%%%%%%%%%%%%%%%
%    %        %P   %
% %% % %%  %% % %% %
% %     %  %     % %
% % %% %%  %% %% % %
%           % %    %
% %    %%%%%% %  % %
% %    %    % %  % %
% %    % %%%% %  % %
% %           %  % %
% %% % %%%%%% % %% %
%.   %        %    %
%%%%%%%%%%%%%%%%%%%%
