%%%%%%%%%%%%%%%%%%%%
%    %        %    %
% %%P% %%  %% % %% %
% %     %  %     % %
% % %% %%  %% %% % %
%           % %    %
% %    %%%%%% %  % %
% %    %    % %  % %
% %    % %%%% %  % %
% %           %  % %
% %% % %%%%%% % %%.%
%    %        %    %
%%%%%%%%%%%%%%%%%%%%
