%%%%%%%%%%%%%%%%%%%%%%%%%%%%%%%
%     %    .            %     %
% %%% % %%% %%%%%%% %%% %     %
% %   % %      %      % %     %
%   %%% % %%%%P% %%%%   %%%   %
%%% % % % %      %  % %   % %%%
%   % %%% % %%% %%% % %%% %   %
% %%%       %     %       %%% %
%   % %%%%% %%%%%%% % %%% %   %
%%% %   % %    %    % %   % %%%
%   %%% % %%%% % %%%% % %%%   %
%       %      %      %     % %
%     % %%% %%%%%%% %%% % %%% %
%     %             %   %     %
%%%%%%%%%%%%%%%%%%%%%%%%%%%%%%%
