%%%%%%%%%%%%%%%%%%%
%   P             %
% % % %%%%%% % %% %
% % % %    %.%  % %
% %%% %  %%% %  % %
%            %  % %
%%%%%%%%%%%%%%%%%%%%
