%%%%%%%%%%%%%%%%%%%
%                 %
% % % %%%%%% % %% %
%P% % %    % %  % %
% %%% %  %%% %  % %
%    .       %  % %
%%%%%%%%%%%%%%%%%%%%
