%%%%%%%%%%%%%%%%%%%%
%    %.       %    %
% %% % %%  %% % %% %
%           % P    %
% % %% %% %%% %% % %
% %    %    % %  % %
% % %% % %% % % %% %
% %           %    %
%%%%%%%%%%%%%%%%%%%%
