%%%%%%%%%%%%%%%%%%%%
%    % .      %    %
% %% % %%  %% % %% %
%           %      %
% % %% %% %%% %% % %
% %    %    % %  % %
% % %% % %% % %P%% %
% %           %    %
%%%%%%%%%%%%%%%%%%%%
