%%%%%%
%   .%
% %% %
% %% %
%    %
% %%%%
% P  %
%%%%%%