%%%%%%
%    %
% %% %
% %% %
%   P%
%.%%%%
%    %
%%%%%%