%%%%%%%%%%%%%%%%%%%%
%    %        %    %
% %% % %%%%%% % %% %
%P%              % %
% % %% %%  %% %% % %
%      %    %      %
% % %% %%%%%% %% % %
% %              % %
% %% % %%%%%% % %% %
%   .%        %    %
%%%%%%%%%%%%%%%%%%%%
