%%%%%%%%%%%%%%%%%%%%%%%%%%%%%%%
%            %%%%%            %
%%% %   %%%         % %   % %%%
%   %%% %.%%%% % %%%%%% %%%   %
% %     %      %      %     % %
% %%% %%%%% %%%%%%% %%% % %%%%%
%   P %             %   %     %
%%%%%%%%%%%%%%%%%%%%%%%%%%%%%%%
