%%%%%%%%%%%%%%%%%%%%
%    %        %    %
% %% % %%%%%% % %% %
% %              % %
% % %% %%  %% %% % %
%      %    %  . P %
% % %% %%%%%% %% % %
% %              % %
% %% % %%%%%% % %% %
%    %        %    %
%%%%%%%%%%%%%%%%%%%%
