%%%%%%%%%%%%%%%%%%%%%%%%%%%%%%%
% %            P %%%%%%    %% %
% % %%%%%%% %%%%%%%     %%%%% %
% %%% %%%%% %%%%%%% %%% % %%% %
%                   %  .      %
%%%%%%%%%%%%%%%%%%%%%%%%%%%%%%%
