%%%%%%%%%%%%%%%%%%%%
%   %         %%   %
% % % %%%%%%%%%% % %
%      .           %
%%%%%%%% % %%%%%%% %
%%%%%%%%P          %
%%%%%%%%%%%%%%%%%%%%
