%%%%%%%%%%%%%%%%%%%%
%   %         %%   %
% % % %%%%%%%%%%.% %
%  P               %
%%%%%%%% % %%%%%%% %
%%%%%%%%           %
%%%%%%%%%%%%%%%%%%%%
