%%%%%%%%%%%%%%%%%%%%
%      %  P %      %
%  %   %%  %%   %  %
% %  %      . %  % %
%  % % %%%%%% % %  %
%                  %
%%%%%%%%%%%%%%%%%%%%
