%%%%%%%%%%%%%%%%%%%%
%      %    %      %
%  %   %%  %%   %  %
% %  %        %  % %
%  % % %%%%%% % %  %
%      .   P       %
%%%%%%%%%%%%%%%%%%%%
