%%%%%%%%%%%%%%%%%%%%%%
% %%        % %      %
%    %%%%%% % %%%%%% %
%%%%%%        %      %
%    % %%%%%% %% %%%%%
% %%%% %    P    %   %
%        %%% %%%   % %
%%%%%%%%%% .  %%%%%% %
%          %%        %
%%%%%%%%%%%%%%%%%%%%%%