%%%%%%%%%%%%%%%%%%%%
%                  %
% %% %%.%% %% %% % %
% %% % P         % %
%%%%%%%%%%%%%%%%%%%%
