%%%%%%%%%
%       %
%%% %%%%%
%       %
%%%%%%% %
%       %
% %%%%% %
%     % %
%%%%%.% %
% P   % %
% %%%%%%%
%       %
%%%%%%% %
%       %
%%%%%%%%%
