%%%%%%%%%
%       %
%%%% %% %
%  P    %
% %% %% %
% %   . %
%%%%%%%%%
