%%%%%%%
%  P  %
% %%% %
%  % .%
%%   %%
%  %%%%
%%%%%%%
