%%%%%%%%%%%%%%%%%%%%
% .  %        %    %
% %% % %%  %% % %% %
% %     %  %     % %
% % %% %%  %% %% % %
%           % %    %
% %    %%%%%% %  % %
% %    %    % %  % %
% %    % %%%% %  % %
% %   P       %  % %
% %% % %%%%%% % %% %
%    %        %    %
%%%%%%%%%%%%%%%%%%%%
