%%%%%%%%%%%%%%%%%%%%
%              %   %
% %% %% %% %% %% % %
%       .        % %
%%%%%%%%%%%%%%%%%% %
%             P    %
%%%%%%%%%%%%%%%%%%%%
