%%%%%%%%%%%%%%%%%%%%%%%%%%%%%%%%%%%%
%                                  %
%                                  %
%                                  %
%                                  %
%                                  %
%                 P                %
%                                  %
%                                  %
%                                  %
%                                  %
%                                  %
%                                  %
%                                  %
%                                  %
%                                  %
%                                  %
%                                  %
%                                  %
%                                  %
%                                  %
%                                  %
%                                  %
%                                  %
%                                  %
%                                  %
%                                  %
%                                  %
%.                                 %                                
%%%%%%%%%%%%%%%%%%%%%%%%%%%%%%%%%%%%